002 003 003 003 003 003 003 003 003 003 003 003 003 003 003 003 003 003 003 003 003 003 003 003 004
047 175 175 129 051 047 127 175 175 175 175 175 175 175 175 175 175 175 129 051 047 127 175 175 051
047 175 175 175 051 047 175 175 175 175 175 175 175 175 175 175 175 175 175 051 047 175 175 175 051
025 175 175 175 051 047 175 175 175 175 175 175 175 175 175 175 175 175 175 051 047 175 175 175 051
071 175 175 175 051 047 056 055 056 055 055 056 057 056 056 057 057 175 175 051 047 175 175 175 027
047 175 175 175 051 047 175 175 175 175 175 175 175 175 175 175 175 175 175 051 047 175 175 175 073
047 175 175 175 051 047 175 175 175 175 175 175 175 175 175 175 175 175 175 051 047 175 175 175 051
047 175 175 175 051 047 175 175 175 175 199 073 071 219 175 175 175 175 175 051 047 175 175 175 051
047 175 175 175 051 047 175 175 175 175 129 051 047 127 175 175 175 175 175 051 047 175 175 175 051
047 175 175 175 051 047 175 175 055 055 057 051 047 056 055 056 057 175 175 051 047 175 175 175 051
047 175 175 175 051 047 175 175 175 175 175 051 047 175 175 175 175 175 175 051 047 175 175 175 051
047 175 175 175 051 047 175 175 175 175 175 051 047 175 175 175 175 175 175 051 047 175 175 175 051
047 175 175 175 051 047 175 175 175 175 175 051 047 175 175 055 056 057 056 051 047 175 175 175 051
047 175 175 175 051 047 055 055 057 175 175 051 047 175 175 175 175 175 175 051 047 175 175 175 051
047 175 175 175 051 047 175 175 175 175 175 051 047 175 175 175 175 175 175 051 047 175 175 175 051
047 175 175 175 051 047 175 175 175 175 175 051 047 056 055 056 057 175 175 051 047 175 175 175 051
047 175 175 199 051 047 219 175 175 175 175 051 047 175 175 175 175 175 199 051 047 219 175 175 051
047 175 175 129 066 065 127 175 175 175 175 051 047 175 175 175 175 175 129 066 065 127 175 175 051
047 175 175 175 175 175 175 175 055 055 057 051 047 175 175 175 175 175 175 175 175 175 175 175 051
047 175 175 175 175 175 175 175 175 175 175 051 047 175 175 175 175 175 175 175 175 175 175 175 051
047 175 175 175 175 175 175 175 175 175 175 051 047 175 175 175 175 175 175 175 175 175 175 175 051
047 175 175 175 175 175 175 175 175 175 199 051 047 219 175 175 175 175 175 175 175 175 175 175 051
070 030 030 030 030 030 030 030 030 030 030 030 030 030 030 030 030 030 030 030 030 030 030 030 096

