002 003 003 003 003 003 003 051 047 003 065 066 003 003 003 003 003 003 003 003 003 003 003 003 004
047 175 175 175 175 175 129 051 047 127 175 175 175 175 175 175 012 175 175 175 175 175 175 175 051
047 175 175 175 175 175 175 051 047 175 175 175 175 175 175 175 058 175 175 175 175 175 175 175 051
047 175 175 175 175 175 175 051 047 055 056 175 175 175 057 055 035 175 175 175 175 175 175 175 051
047 175 199 073 071 219 175 051 047 175 175 175 175 175 175 175 012 175 175 175 175 175 175 175 051
047 175 129 051 047 127 175 051 047 175 175 175 175 175 175 175 012 175 175 175 175 175 175 199 051
047 175 175 051 047 175 175 051 047 175 175 175 175 175 175 175 058 175 175 175 175 175 199 215 051
047 175 175 051 047 175 175 051 047 175 175 175 175 175 175 175 035 175 175 175 175 199 215 238 051
025 175 175 051 047 175 175 051 047 175 175 175 175 175 175 175 175 175 175 175 199 215 238 238 027
071 175 175 051 047 175 175 051 047 175 175 175 175 175 175 175 174 175 175 175 129 307 238 238 073
047 175 175 051 047 175 175 051 047 175 175 175 175 175 175 175 175 175 175 175 175 129 307 238 051
047 175 175 051 047 175 175 051 047 175 175 175 175 175 175 175 175 175 175 175 175 175 129 307 051
047 175 175 051 047 175 175 051 047 175 175 175 175 175 175 175 175 175 175 175 175 175 175 129 051
047 175 175 051 047 175 175 051 047 175 175 175 175 175 175 175 175 175 175 175 175 175 175 175 051
047 175 175 051 047 175 175 051 047 175 175 175 175 175 175 175 175 175 175 175 175 175 175 175 051
047 175 175 051 047 175 175 051 047 175 175 175 175 175 175 175 035 175 175 175 175 175 175 175 051
047 175 175 051 047 175 175 051 047 175 175 175 175 175 175 175 012 175 175 175 175 175 175 175 051
047 175 175 051 047 175 199 051 047 219 175 175 175 175 175 175 012 175 175 175 175 175 175 175 051
047 175 175 051 047 175 129 066 065 127 175 175 175 175 175 175 058 175 175 175 175 175 175 175 051
047 175 175 051 047 175 175 175 175 175 175 175 175 175 175 175 035 175 175 175 175 175 175 175 051
047 175 175 051 047 175 175 175 175 175 175 175 175 175 175 175 012 175 175 175 175 175 175 175 051
047 175 199 051 047 219 175 175 175 175 175 175 175 175 175 175 012 175 175 175 175 175 175 175 051
070 030 030 051 047 030 030 030 030 030 030 030 030 030 030 030 030 030 030 030 030 030 030 030 096

