002 003 003 003 003 003 003 051 047 003 003 003 003 003 003 003 003 003 003 003 003 003 003 003 004
047 173 175 175 175 175 129 051 047 127 175 175 175 175 175 175 175 175 175 175 175 175 175 175 051
047 175 175 175 056 055 057 051 047 175 175 176 175 175 172 175 175 175 173 175 175 175 175 175 051
025 175 176 172 175 175 175 051 047 175 197 175 175 173 175 175 175 172 175 172 175 056 057 055 051
071 175 175 175 175 175 175 051 047 175 175 175 175 175 175 058 176 175 175 175 175 175 175 175 027
047 172 175 175 176 175 175 051 047 173 175 176 175 172 175 035 175 175 175 175 176 175 175 175 073
047 175 175 197 175 175 175 051 047 175 172 175 173 173 175 012 175 175 175 174 172 175 175 175 051
047 175 175 173 175 175 175 051 047 175 175 175 175 175 175 012 175 175 197 175 175 175 175 175 051
002 055 057 056 197 175 175 051 047 055 057 056 057 055 056 055 057 175 175 176 173 175 175 175 051
047 175 175 175 175 175 175 051 047 175 175 175 012 175 175 175 175 175 175 175 175 175 175 175 051
047 175 197 172 175 175 175 051 047 175 175 175 012 175 176 172 175 173 174 175 175 057 056 055 051
047 175 175 176 173 175 199 051 047 219 175 175 035 175 175 175 175 175 175 175 175 175 175 175 051
047 175 175 175 175 175 129 066 065 127 175 175 058 175 175 175 175 175 175 173 175 175 175 175 051
047 175 175 175 175 172 175 175 175 173 172 175 175 176 197 175 176 175 175 175 176 175 173 175 051
047 175 173 175 175 175 175 173 175 175 175 175 173 175 175 175 175 199 073 071 219 175 175 175 051
047 172 175 175 175 173 176 175 173 175 175 175 175 175 175 175 172 129 051 047 127 172 175 176 051
047 175 175 175 175 175 175 175 172 175 176 175 175 172 175 173 175 175 051 047 175 175 175 197 051
047 175 173 175 175 199 073 071 219 175 175 175 175 175 175 057 056 055 051 047 175 176 175 175 051
047 176 175 175 175 129 051 047 127 175 175 175 175 176 175 175 175 175 051 047 173 175 172 175 051
047 175 175 172 175 175 051 047 175 175 175 197 175 175 175 175 175 175 051 047 175 175 175 173 051
047 175 175 056 057 055 051 047 175 173 175 175 173 175 175 175 175 175 051 047 055 057 055 175 051
047 175 175 175 175 199 051 047 219 175 175 175 175 175 175 175 175 199 051 047 219 175 175 175 051
070 030 030 030 030 030 051 047 030 030 030 071 073 030 030 030 030 030 051 047 030 030 030 030 096

