002 003 003 003 003 003 003 003 003 003 003 065 066 051 047 003 003 003 003 003 003 003 003 003 004
047 175 174 175 175 175 174 175 175 175 175 174 129 051 047 127 175 175 174 175 175 175 174 175 051
047 175 175 175 175 174 175 175 175 175 175 174 175 051 047 175 174 175 175 175 174 175 175 175 027
047 174 175 175 175 174 175 175 175 174 175 175 174 051 047 175 175 175 174 175 175 174 175 175 073
047 175 174 175 175 175 175 175 174 175 175 175 174 051 047 175 175 175 174 175 175 175 174 175 051
047 175 175 174 175 175 174 175 175 174 175 175 175 051 047 174 175 199 073 071 219 175 174 175 051
047 174 175 175 175 174 175 175 174 175 175 174 175 051 047 175 174 129 051 047 127 175 174 175 051
047 175 174 175 175 174 055 056 057 056 055 057 057 051 047 175 175 174 051 047 056 056 057 175 051
047 175 174 175 175 174 129 051 047 127 175 174 199 051 047 219 175 175 051 047 174 175 174 175 051
047 174 175 175 174 175 174 051 047 174 175 175 129 066 065 127 175 174 051 047 175 175 175 175 051
047 175 175 174 175 174 175 051 047 175 174 175 175 174 175 175 174 175 051 047 175 056 056 057 051
002 055 056 057 056 175 174 051 047 175 175 174 175 174 175 175 175 175 051 047 174 175 174 175 051
047 175 174 175 175 174 175 051 047 175 175 174 175 175 174 175 175 175 051 047 174 175 175 174 051
047 175 174 175 175 174 175 051 047 175 174 175 174 175 174 175 175 174 051 047 056 056 057 175 051
047 174 175 055 056 057 056 051 047 175 174 175 174 175 175 174 175 175 051 047 174 175 174 175 051
047 174 175 174 175 174 175 051 047 175 174 175 174 175 175 174 175 175 051 047 174 175 174 175 051
047 175 175 174 175 175 174 051 047 175 174 175 175 175 174 175 174 175 051 047 174 056 056 057 051
047 055 056 057 056 175 175 051 047 056 056 057 056 055 057 174 175 174 051 047 175 174 175 175 051
047 175 174 175 174 175 199 051 047 219 175 174 175 175 175 174 175 175 051 047 175 174 175 199 051
047 175 175 175 174 175 129 066 065 127 175 175 174 175 175 174 175 174 051 047 056 056 057 215 051
047 175 174 175 174 175 175 175 174 175 174 175 174 175 175 175 174 175 051 047 238 238 238 238 051
047 175 175 174 175 175 174 175 175 175 174 175 175 174 175 175 174 199 051 047 283 238 238 238 051
070 030 030 030 030 030 030 030 030 030 030 030 030 030 030 030 030 030 030 030 030 030 030 030 096

