002 003 003 003 003 003 003 003 003 003 003 003 003 003 003 003 003 003 003 003 003 003 003 003 004
047 197 175 175 175 174 175 175 175 197 175 175 174 175 175 174 175 175 174 175 175 175 174 174 051
047 175 175 175 175 174 174 174 174 175 175 175 174 175 175 175 175 197 174 175 175 174 175 174 051
047 175 174 175 175 175 174 175 174 175 174 175 174 175 174 175 175 174 175 174 175 197 174 175 051
047 174 175 174 175 175 175 174 175 174 175 197 174 175 174 175 175 174 175 174 174 175 174 175 051
047 175 174 175 174 175 175 174 175 174 175 174 175 174 175 197 175 174 175 174 174 175 197 175 051
047 174 175 174 175 174 197 175 174 175 174 197 174 175 175 175 174 175 174 174 175 197 175 174 051
047 175 197 174 175 174 175 175 174 175 174 175 174 175 175 174 175 175 174 197 175 174 175 175 051
047 175 174 175 174 175 175 174 175 174 175 175 174 175 174 175 174 175 197 174 175 174 175 174 051
047 175 174 197 175 197 175 175 175 174 175 174 175 174 175 174 175 175 175 175 174 174 175 174 051
047 175 174 175 174 175 174 175 174 175 174 175 174 175 174 175 197 175 174 175 174 175 174 174 051
047 175 174 175 174 175 175 175 175 175 197 174 174 197 174 175 175 175 174 175 174 197 175 174 051
047 175 175 174 174 174 175 175 174 175 174 175 174 175 175 175 175 174 175 174 175 174 175 174 051
047 175 175 175 174 174 175 197 174 175 174 175 197 175 174 175 174 175 174 175 174 175 175 174 051
047 175 174 175 175 175 174 174 175 197 174 175 174 175 174 197 175 174 175 174 175 174 175 174 051
047 175 174 175 175 174 175 174 175 174 175 175 174 174 175 175 175 174 175 174 197 174 175 174 051
047 175 197 175 175 174 174 175 174 175 175 174 175 174 174 175 174 175 175 175 175 175 174 175 051
047 174 174 175 174 175 174 175 174 175 174 174 174 174 175 175 174 175 174 174 174 175 174 175 051
047 174 175 174 197 175 174 175 174 175 175 175 197 174 197 175 174 175 174 175 174 174 175 197 051
047 175 175 174 174 175 174 175 175 174 175 174 174 175 175 174 174 175 174 175 175 175 197 174 051
047 174 175 175 197 174 175 174 175 174 175 174 174 175 175 174 175 174 175 174 175 175 175 175 051
047 174 175 174 174 175 174 175 175 175 174 175 174 175 175 174 175 174 197 197 175 174 174 175 051
070 030 030 030 030 030 030 030 030 030 030 030 030 030 030 030 030 030 030 030 030 030 030 030 096

