002 003 003 003 003 003 003 003 003 051 047 003 003 003 003 003 003 003 003 051 047 003 003 003 004
047 175 175 175 175 175 175 175 129 051 047 127 175 175 175 175 175 175 129 051 047 127 175 175 051
047 174 175 172 175 173 175 175 175 051 047 197 173 175 175 176 175 175 175 051 047 175 175 175 051
047 175 175 173 175 175 176 175 175 051 047 055 057 056 175 175 175 197 175 051 047 175 197 175 051
025 175 173 175 175 175 175 175 175 051 047 175 175 172 175 175 175 175 175 051 047 175 175 175 051
071 175 175 175 175 175 057 056 055 051 047 175 175 175 175 175 056 055 057 051 047 175 175 175 051
047 175 173 175 175 175 175 175 175 051 047 175 175 175 175 197 175 175 175 051 047 175 175 175 051
047 175 175 175 175 197 175 175 175 051 047 175 175 175 175 175 176 175 175 051 047 175 175 175 051
047 176 175 175 175 175 175 175 175 051 047 174 175 173 175 174 175 175 175 051 047 175 174 175 051
047 175 175 175 174 175 175 175 199 051 047 219 175 175 174 175 175 175 199 051 047 219 175 174 051
002 056 057 055 175 175 172 175 129 066 065 127 175 175 172 175 175 173 129 066 065 127 175 172 051
047 175 175 175 175 175 172 175 175 175 197 175 175 176 172 175 175 175 175 175 175 172 176 175 051
047 175 172 175 199 073 071 219 175 175 172 175 175 175 175 199 073 071 219 176 175 173 175 175 051
047 175 175 172 129 051 047 127 175 176 175 175 175 175 172 129 051 047 127 175 175 175 172 175 051
047 175 175 172 175 051 047 175 173 175 175 175 175 175 175 172 051 047 175 175 175 174 175 175 051
047 173 175 173 175 051 047 175 175 175 175 175 175 173 175 175 051 047 055 057 056 175 175 197 051
047 175 175 175 175 051 047 173 175 175 175 175 175 175 175 175 051 047 175 175 175 175 173 175 051
047 174 176 172 175 051 047 057 056 055 175 175 173 175 174 175 051 047 175 197 175 175 174 175 051
047 175 175 175 175 051 047 175 175 175 174 175 175 175 175 175 051 047 175 175 175 057 056 055 051
047 197 175 173 175 051 047 197 173 175 175 175 197 175 173 175 051 047 175 175 175 175 175 175 051
047 175 172 175 175 051 047 175 175 172 175 173 175 175 175 175 051 047 175 175 175 175 197 175 051
047 175 175 175 199 051 047 219 175 175 175 175 175 175 175 199 051 047 219 175 176 175 175 175 051
070 030 030 030 030 051 047 030 030 030 030 030 030 030 030 030 051 047 030 030 030 071 073 030 096

