002 003 003 003 003 003 003 003 003 065 066 003 003 003 003 003 003 003 003 003 003 003 003 003 004
047 172 175 176 175 174 173 174 175 176 173 175 175 173 175 175 197 175 172 174 175 175 175 172 051
047 175 174 197 175 175 172 173 176 175 174 173 174 172 172 172 175 197 175 172 175 175 173 175 051
047 173 175 175 173 174 197 174 172 175 175 172 174 175 173 175 173 172 173 176 175 175 175 175 051
047 175 175 172 197 175 197 175 197 173 175 197 197 176 175 174 175 173 197 175 175 175 197 175 051
047 056 057 055 175 176 199 073 071 219 174 197 175 175 176 199 073 071 219 197 175 175 175 197 051
047 175 175 175 175 197 129 051 047 127 175 173 173 172 175 129 051 047 127 197 174 173 174 175 051
047 175 197 175 175 175 175 051 047 055 056 057 056 057 173 197 051 047 055 057 175 175 176 057 051
047 173 197 057 055 057 056 051 047 175 197 175 175 197 175 175 051 047 175 175 197 175 175 175 051
047 172 197 175 175 175 175 051 047 197 173 175 174 175 176 197 051 047 055 175 175 175 055 057 051
047 174 197 176 175 175 175 051 047 176 174 175 057 056 055 056 051 047 175 175 175 197 175 175 051
047 175 197 175 174 175 172 051 047 197 175 175 175 175 197 175 051 047 175 175 175 175 197 175 051
047 056 057 055 057 175 174 051 047 175 197 175 175 175 197 175 051 047 057 056 055 057 173 175 051
047 175 197 174 175 174 173 051 047 056 056 057 197 175 175 175 051 047 175 197 175 175 176 176 051
047 197 175 176 175 175 175 051 047 175 175 174 175 175 175 175 051 047 197 175 175 175 174 173 051
047 055 174 175 055 057 056 051 047 175 173 175 175 057 056 055 051 047 056 057 055 176 197 056 051
047 175 175 175 172 173 199 051 047 219 175 174 197 173 175 199 051 047 219 175 174 175 197 174 051
047 175 174 175 197 176 129 066 065 127 172 174 172 172 175 129 066 065 127 197 176 174 175 173 051
047 173 175 175 173 175 197 172 176 175 176 176 175 176 197 172 176 172 175 173 175 175 197 172 051
047 175 175 176 197 174 173 176 174 175 174 174 174 174 174 174 174 173 197 174 172 173 174 175 051
047 175 172 197 175 175 175 173 175 172 197 173 176 175 176 175 176 176 174 176 197 173 176 175 051
047 175 175 175 197 176 172 176 173 176 174 172 173 173 173 176 197 175 173 175 175 176 172 173 051
070 030 030 030 030 030 030 030 030 030 030 030 030 071 073 030 030 030 030 030 030 030 030 030 096

