002 003 003 003 003 003 003 003 003 003 003 065 066 003 003 003 003 051 047 003 003 003 003 003 004
047 175 175 197 175 175 175 175 175 175 175 175 173 175 175 176 129 051 047 127 176 175 172 175 051
047 175 173 175 173 197 175 174 175 175 174 174 175 172 175 175 172 051 047 175 175 175 174 173 051
047 174 175 172 175 058 175 175 176 172 175 172 174 176 175 176 175 051 047 197 173 172 175 172 051
047 175 172 173 175 035 173 172 175 175 173 175 175 175 175 175 173 051 047 175 175 057 055 055 051
047 175 175 172 176 058 175 175 176 175 172 173 175 175 175 175 175 051 047 175 175 175 176 175 051
047 175 176 175 175 035 175 197 173 175 175 175 175 175 175 175 175 051 047 174 197 175 172 175 051
047 197 175 172 175 012 172 175 175 175 197 175 175 175 176 197 174 051 047 175 175 175 173 197 051
047 175 174 176 173 012 176 175 197 175 175 175 175 175 175 175 175 051 047 055 056 057 174 175 051
002 055 056 057 056 055 057 057 055 055 056 057 175 175 174 175 175 051 047 175 175 172 175 175 051
047 172 175 175 175 175 172 175 175 175 175 176 174 175 175 175 173 051 047 175 172 175 175 175 051
047 175 175 175 175 175 197 175 175 175 175 175 175 175 172 175 175 051 047 173 176 175 175 175 051
047 175 175 175 175 175 173 176 175 175 175 175 175 175 175 175 172 051 047 175 175 056 057 057 051
047 175 175 173 175 199 073 071 219 175 175 175 175 175 175 175 197 051 047 175 175 175 175 175 051
047 197 175 175 175 129 051 047 127 175 175 175 175 175 173 175 175 051 047 175 197 175 175 197 051
047 175 197 175 174 176 051 047 175 175 175 175 175 175 175 175 199 051 047 219 175 175 175 175 051
047 175 175 055 056 057 051 047 175 175 175 175 175 175 175 175 129 066 065 127 175 056 055 056 051
047 175 176 175 173 175 051 047 175 175 175 175 175 175 197 175 175 173 176 175 175 174 175 175 051
047 175 175 172 175 175 051 047 057 057 055 056 057 175 175 175 175 175 173 175 175 175 173 175 051
047 173 176 172 174 175 051 047 175 175 175 175 175 175 176 175 172 175 175 175 175 175 197 197 051
047 175 176 175 175 175 051 047 175 175 175 175 175 175 173 175 175 175 174 176 174 175 172 176 051
047 172 175 175 197 199 051 047 219 175 175 175 175 175 172 197 175 175 175 172 173 175 175 175 051
070 030 030 030 030 030 051 047 030 071 073 030 030 030 030 030 030 030 030 030 030 030 030 030 096

