002 003 003 003 003 003 003 051 047 003 003 065 066 003 003 003 003 003 051 047 003 003 003 003 004
047 175 175 175 175 175 129 051 047 127 175 175 175 175 175 175 175 129 051 047 127 175 175 175 051
047 175 175 175 175 175 175 051 047 175 175 175 175 175 175 175 175 175 051 047 175 175 175 175 051
047 175 175 175 057 056 055 051 047 175 175 175 175 175 175 175 175 175 051 047 056 057 055 175 051
047 175 175 175 175 175 175 051 047 175 175 175 175 175 175 175 175 175 051 047 175 175 175 175 051
047 175 175 175 175 175 175 051 047 175 175 175 175 175 175 175 175 175 051 047 175 175 175 175 051
047 175 175 175 175 175 199 051 047 219 175 175 175 175 175 175 175 199 051 047 219 175 175 175 051
047 175 175 175 175 175 129 066 065 127 175 175 175 175 175 175 175 129 066 065 127 175 175 175 051
047 175 175 175 175 175 175 175 175 175 175 175 175 175 175 175 175 175 175 175 175 175 175 175 051
047 175 175 175 175 175 175 175 175 175 175 175 175 175 175 175 175 175 175 175 175 175 175 175 051
047 175 175 175 175 175 175 175 175 175 175 175 175 175 175 175 175 175 175 175 175 175 175 175 051
047 175 175 175 175 175 175 175 175 175 175 175 175 175 175 175 175 175 175 175 175 175 175 175 051
047 175 175 175 175 175 175 175 175 175 175 175 175 175 175 175 175 175 175 175 175 057 056 055 051
047 175 175 175 175 175 175 175 175 175 175 199 073 071 219 175 175 175 175 175 175 175 175 175 051
047 175 175 175 175 175 175 175 175 175 175 129 051 047 127 175 175 175 175 175 175 175 175 175 051
047 175 175 175 175 175 175 175 175 175 175 175 051 047 175 175 175 175 175 175 175 175 175 175 051
047 175 175 175 175 175 175 175 175 055 056 057 051 047 175 175 175 175 175 175 175 175 175 175 051
047 175 175 175 175 175 175 175 175 175 175 175 051 047 055 056 057 175 175 175 175 175 175 175 051
047 175 175 175 175 175 175 175 175 175 175 175 051 047 175 175 175 175 175 175 175 175 175 175 051
047 175 175 175 175 175 175 175 175 175 175 175 051 047 175 175 175 175 175 175 175 175 175 175 051
047 175 175 175 175 175 175 175 175 175 175 175 051 047 175 175 175 175 175 175 175 175 175 175 051
047 175 175 175 175 175 175 175 175 175 175 199 051 047 219 175 175 175 175 175 175 175 175 175 051
070 030 030 030 030 030 030 030 030 030 030 030 051 047 030 030 030 030 071 073 030 030 030 030 096

