002 003 003 003 003 003 003 003 003 003 003 003 003 003 003 003 003 003 003 003 003 003 003 003 004
047 197 175 175 175 174 175 175 197 199 215 051 047 127 174 175 175 174 175 175 175 174 174 175 051
047 175 175 175 175 174 174 174 199 215 238 051 047 175 175 175 197 174 175 175 174 175 174 175 051
047 175 174 175 175 175 174 199 215 238 238 051 047 174 175 175 174 175 174 175 197 174 175 175 051
047 174 175 174 175 175 199 215 238 238 238 051 047 174 175 175 174 175 174 174 058 174 175 174 051
047 175 174 175 174 199 215 238 238 238 238 051 047 175 197 175 174 175 174 174 035 197 175 175 051
047 174 175 174 175 035 238 238 238 238 287 051 047 175 175 174 175 174 174 175 012 175 174 174 051
047 175 197 056 057 056 055 057 057 055 055 051 047 175 174 175 175 174 197 175 058 175 175 175 051
047 175 174 175 174 035 175 175 174 175 199 051 047 219 175 174 175 197 174 175 035 175 174 175 051
047 175 174 197 175 012 175 175 174 175 129 066 065 127 174 175 175 175 175 174 035 175 174 175 051
047 175 174 175 174 012 174 174 175 174 175 174 175 174 175 197 175 174 175 174 012 174 174 174 051
047 175 174 175 174 058 175 175 175 197 174 174 197 174 175 175 175 174 175 174 012 175 174 174 051
047 175 175 174 174 035 175 174 175 174 175 174 175 175 175 175 174 175 174 175 058 175 174 175 051
047 175 175 175 174 012 175 174 175 174 175 197 175 174 175 174 175 174 175 174 035 175 174 175 051
047 175 174 175 175 058 174 175 197 174 199 073 071 219 197 175 174 175 174 175 035 175 174 175 051
047 175 174 175 175 012 175 175 174 175 129 051 047 127 175 175 174 175 174 197 012 175 174 174 051
047 175 197 175 175 035 174 174 175 175 174 051 047 055 056 057 056 055 057 057 055 056 175 174 051
047 174 174 175 174 058 174 174 175 174 174 051 047 175 175 174 175 174 174 174 035 174 175 174 051
047 174 175 174 197 035 174 174 175 175 175 051 047 197 175 174 175 174 175 174 174 175 197 174 051
047 175 175 174 174 175 174 175 174 175 174 051 047 175 174 174 175 174 175 175 175 197 174 175 051
047 174 175 175 197 174 175 175 174 175 174 051 047 175 174 175 174 175 174 175 175 175 175 174 051
047 174 175 174 174 175 174 175 175 174 199 051 047 219 174 175 174 197 197 175 174 174 175 175 051
070 030 030 030 030 030 030 030 030 030 030 030 030 030 030 071 073 030 030 030 030 030 030 030 096

