
002 003 003 003 003 003 003 003 003 003 003 003 003 003 003 003 003 003 003 003 003 003 003 003 004
047 173 175 176 175 012 175 176 175 175 174 175 176 175 173 175 175 175 176 175 199 215 238 238 051
047 174 175 175 176 035 175 176 175 173 175 175 175 173 175 176 175 174 175 199 215 238 238 238 051
047 175 175 173 175 012 173 175 176 175 174 175 175 176 175 173 175 176 175 129 283 238 238 309 051
047 173 175 176 175 174 175 175 175 176 175 176 175 175 175 173 175 174 175 176 129 283 309 127 051
047 175 173 175 175 175 176 175 175 173 175 174 175 173 175 176 175 175 173 197 175 129 127 197 051
047 175 197 174 197 058 175 197 197 173 175 176 197 175 197 175 173 175 176 175 175 197 174 175 051
047 197 176 197 055 055 056 057 056 055 057 057 055 055 056 057 056 055 057 057 055 055 056 057 051
047 175 197 175 173 175 176 197 175 197 175 176 175 197 173 175 175 175 197 176 175 175 197 174 051
047 175 175 176 197 173 175 175 175 176 197 173 175 175 176 175 197 175 174 175 175 197 176 175 051
047 173 175 197 176 175 173 175 197 175 175 176 175 197 174 175 197 176 035 175 173 197 175 176 051
047 175 175 173 197 176 175 175 173 197 175 176 174 175 197 175 175 176 012 175 197 173 175 197 051
047 055 056 057 056 055 057 057 055 055 056 057 055 056 057 056 055 057 055 057 057 176 175 197 051
047 173 175 175 176 197 175 174 175 175 176 197 175 175 175 175 175 197 035 173 175 176 175 173 051
047 197 175 175 175 175 197 174 175 176 175 173 197 175 175 175 176 175 058 173 197 175 175 175 051
047 175 197 176 175 175 176 197 175 175 175 174 175 197 175 173 175 175 197 175 176 175 175 197 051
047 173 175 175 176 197 175 175 176 175 175 175 174 175 197 175 176 175 175 173 197 175 176 175 051
047 175 175 173 055 055 056 057 056 055 057 057 055 055 056 057 056 055 057 057 055 055 056 057 051
047 197 175 175 176 012 175 175 173 197 175 176 175 175 174 197 175 175 175 173 197 175 175 173 051
047 175 174 197 175 175 173 175 176 175 175 197 176 175 175 173 175 175 197 174 175 173 175 197 027
047 175 176 175 173 197 175 176 175 175 174 197 175 175 176 175 173 197 175 176 175 175 197 173 073
047 175 174 197 175 035 176 175 173 174 175 175 175 175 175 197 175 176 173 175 176 197 175 175 051
070 030 030 030 030 030 030 030 030 030 030 030 030 030 030 030 030 030 030 030 030 030 030 030 096

